
NO textures/school/wood.xpm
SO textures/school/mossy.xpm
WE textures/school/grey_stone.xpm
EA textures/custom/american_cheese_broken.xpm

C 255,215,34
F 255,215,34 
                         
11111111111111111111111111111111111111
11111111111111111111111111111111111111
11111111111111111111111111111111111111
11111111111111111111111111111111111111
11111111111111111111111111111111111111
11111111111111111111100000101000101000001
1011111010111011111111111111111111111111
101000001010100000101111111111111111111
1010111110101111101011111111111111111
101010001010100010101111111111111111
101110101010101010101111111111111111
1N0000000000000010001111111111111111
111111101011111011101111111111111111
100000101000100010001111111111111111
101110101110101110111111111111111111
101000100000100010101111111111111111
101011111111111010101111111111111111
100010000000000010001111111111111111
101010111011111111101111111111111111
11100000100000000011111111111111111
11111111111111111111111111111111111
11111111111111111111111111111111111
11111111111111111111111111111111111









































































