NO textures/school/grey_stone.xpm
SO textures/school/red_brick.xpm
WE textures/school/mossy.xpm
EA textures/school/purple_stone.xpm

F 40,40,40
C 20,20,25

111111111111111
100000000000001
101111111111101
1010000000S1101
101011111101101
101010001001101
101010101001101
101010101101101
101000100001101
101111111111101
100000000000001
111111111111111

