NO textures/custom/doge.xpm
SO textures/custom/gigachad.xpm
WE textures/custom/duolingo.xpm
EA textures/custom/wojak.xpm

F 50,50,50
C 20,20,20

11111111111111111111111111111
1000000N000000000000000000001
10111111111000111111111110001
10100000001000100000000010001
10101111101000101111101010001
10101000101000101000101010001
10101010101000101010101010001
10101010101110101010101010001
10101000100000001000101010001
10101111111111111111101010001
10100000000000000000001010001
10111111111111111111111110001
10000000000000000000000000001
11111111111111111111111111111
