NO textures/custom/minecraft_grass.xpm
SO textures/custom/minecraft_cobble.xpm
WE textures/custom/minecraft_planks.xpm
EA textures/custom/minecraft_stone.xpm

F 120,200,80
C 135,206,235

1111111111111111111111111
1000000001100000000000001
1011000001110000000000001
1001000000000000000000001
1011000001110000000000001
1000000001100001110111111
1111011111111001110000001
1111011111110001101010001
1100000011010001110000001
100000000W000000110000001
1000000000000000110101001
1100000111010101111101001
1111011101110101010111001
1111111111111111111111111
