NO textures/school/color_stone.xpm
SO textures/school/mossy.xpm
WE textures/school/grey_stone.xpm
EA textures/school/wood.xpm

F 40,20,20
C 10,5,5

1111111111111
1000000000001
10N0000000001
1000011110001
1000000000001
1111111111111
