NO textures/custom/matrix_north.xpm
SO textures/custom/matrix_south.xpm
WE textures/custom/trippy_west.xpm
EA textures/custom/trippy_east.xpm

F 25,5,35
C 10,0,20

1111111111111111111111111
1000000000000000000000001
1011111111111111111111101
1010000000000000000001101
1010111111111111111101101
1010100000000000001101101
1010101111111111101101101
1010101000000001101101101
1010101011111101101101101
1010101010001101101101101
1010101010101101101101101
1010101010N01101101101101
1010101010111101101101101
1010101000000001101101101
1010101111111111101101101
1010100000000000001101101
1010111111111111111101101
1010000000000000000001101
1011111111111111111111101
1000000000000000000000001
1111111111111111111111111
