NO textures/school/grey_stone.xpm
SO textures/school/purple_stone.xpm
WE textures/school/red_brick.xpm
EA textures/school/wood.xpm

F 220,100,0
C 225,30,0


    111111111111111111111111111
    1000000000110000000000001
    1011000001110000000000001
    11001000000000000000000001
11111111101100000111000000001
10000000001100000111011111111
11110111111111011100000010001
11110111111111011101010010001
1100010110111011100000010001
10000000000000001100000010001
10000000000000001101010010001
11000001110101011111011110N0111
111101111111010111011110110001
111111111111111111111111111111
111111111111111111111111111111
