NO textures/school/grey_stone.xpm
SO textures/school/red_brick.xpm
WE textures/school/wood.xpm
EA textures/school/blue_stone.xpm

F 100,100,100
C 50,0,0

11111
10001       111
10N01       111
11111
